1111111111111111111111111111111111
1PE000000000000C00000C000000000001
1010010100100001111001000000010101
1000010010101011011001000000010101
101000000C00C001110001000000000011
1111111111111111111111111111111111
