111111111111111111111111111111111111111111111111
100P0111111C000000000000000111111111110000000011
100000011111000000000000000000011111110000000001
100000000000000000000000000000000000000000000001
10000000000000C000000000000000000000000000000001
100000000000000000000000000000000000000000000001
100000000000000000000000000001100000000000000001
100000000000000000100000000111111000000000000001
100000C00000000011100000111111C11111000000000001
100000000000001111100000000110000111111000000001
100001000000000011100000000010000110000000000001
100111000E00000001100000000000000100000000000001
111100000000000000100000000000000000000000000001
111000000000000000100000000000000000000000000011
110000000000000000000000000000000000000000000001
10000000000C000000000000000000000000000000000001
111111111111111111111111111111111111111111111111
