1111111111111111111111111111111111
1E0000000000000C00000C000000000001
1110010100100001111001000000010101
1000010010101011011001000000010101
1P1000000C00C001110001000000000011
1111111111111111111111111111111111
