1111111111111111111111111111111111
1E0000000000000C00100C000000000001
1110010100100000101001000000010101
1000010010101010001001000000010101
1P1000000C00C000000001000000000011
1111111111111111111111111111111111
